7
  1   2   3   4   5   6   7 
 24  25  26  27  28  29   8 
 23  40  41   0  43  30   9 
 22  39  48  42  44  31  10 
 21  38  47  46  45  32  11 
 20  37  36  35  34  33  12 
 19  18  17  16  15  14  13

